01 02 03 04 01 02 03 04 01 02 00 02 03 04 01 02 03 04 01 02 01 02 03 04 01 02 00 04 01 02 01 02 03 04 01 02 03 04 01 02 01 02 03 04 01 02 03 04 01 02 01 02 03 04 01 02 03 04 01 02 03 04 01 02 03 04 01
01 02 03 04 01 02 03 04 01 02 00 02 03 04 01 02 03 04 01 02 01 02 03 04 01 02 03 00 01 02 01 02 03 04 01 02 03 04 01 02 01 02 03 04 01 02 03 04 01 02 01 02 03 04 01 02 03 04 01 02 03 04 01 02 03 04 01
01 02 03 04 01 02 03 04 01 02 00 02 03 04 01 02 03 04 01 02 01 02 03 04 01 02 03 04 00 02 01 02 03 04 01 02 03 04 01 02 01 02 03 04 01 02 03 04 01 02 01 02 03 04 01 02 03 04 01 02 03 04 01 02 03 04 01
01 02 03 04 01 02 03 04 01 02 01 02 03 04 01 02 03 04 01 02 01 02 03 04 01 02 03 04 01 00 01 02 03 04 01 02 03 04 01 02 01 02 03 04 01 02 03 04 01 02 01 02 03 04 01 02 03 04 01 02 03 04 01 02 03 04 01
01 02 03 04 01 02 03 04 01 02 01 02 03 04 01 02 03 04 01 02 01 02 03 04 01 02 03 04 01 02 00 02 03 04 01 02 03 04 01 02 01 02 03 04 01 02 03 04 01 02 01 02 03 04 01 02 03 04 01 02 03 04 01 02 03 04 01
01 02 03 04 01 02 03 04 01 02 01 02 03 04 01 02 03 04 01 02 01 02 03 04 01 02 03 04 01 02 01 00 03 04 01 02 03 04 01 02 01 02 03 04 01 02 03 04 01 02 01 02 03 04 01 02 03 04 01 02 03 04 01 02 03 04 01
01 02 03 04 01 02 03 04 01 02 01 02 03 04 01 02 03 04 01 02 01 02 03 04 01 02 03 04 01 02 01 02 00 04 01 02 03 04 01 02 01 02 03 04 01 02 03 04 01 02 01 02 03 04 01 02 03 04 01 02 03 04 01 02 03 04 01
01 02 03 04 01 02 03 04 01 02 00 02 03 04 01 02 03 04 01 02 01 02 03 04 01 02 03 04 01 02 01 02 03 00 01 02 03 04 01 02 01 02 03 04 01 02 03 04 01 02 01 02 03 04 01 02 03 04 01 02 03 04 01 02 03 04 01
01 02 03 04 01 02 03 04 01 02 00 02 03 04 01 02 03 04 01 02 01 02 03 04 01 02 03 04 01 02 01 02 03 04 00 02 03 04 01 02 01 02 03 04 01 02 03 04 01 02 01 02 03 04 01 02 03 04 01 02 03 04 01 02 03 04 01
00 00 00 00 00 00 00 00 00 00 00 02 03 04 01 02 03 04 01 02 01 02 03 04 01 02 03 04 01 02 01 02 03 04 01 00 03 04 01 02 01 02 03 04 01 02 03 04 01 02 01 02 03 04 01 02 03 04 01 02 03 04 01 02 03 04 01
01 02 03 04 01 02 03 04 01 02 01 02 03 04 01 02 03 04 01 02 01 02 03 04 01 02 03 04 01 02 01 02 03 04 01 02 00 04 01 02 01 02 03 04 01 02 03 04 01 02 01 02 03 04 01 02 03 04 01 02 03 04 01 02 03 04 01
01 02 03 04 01 02 03 04 01 02 01 02 03 04 01 02 03 04 01 02 01 02 03 04 01 02 03 04 01 02 01 02 03 04 01 02 03 00 01 02 01 02 03 04 01 02 03 04 01 02 01 02 03 04 01 02 03 04 01 02 03 04 01 02 03 04 01
01 02 03 04 01 02 03 04 01 02 01 02 03 04 01 02 03 04 01 02 01 02 03 04 01 02 03 04 01 02 01 02 03 04 01 02 03 04 00 02 01 02 03 04 01 02 03 04 01 02 01 02 03 04 01 02 03 04 01 02 03 04 01 02 03 04 01
01 02 03 04 01 02 03 04 01 02 01 02 03 04 01 02 03 04 01 02 01 02 03 04 01 02 03 04 01 02 01 02 03 04 01 02 03 04 01 00 01 02 03 04 01 02 03 04 01 02 01 02 03 04 01 02 03 04 01 02 03 04 01 02 03 04 01
01 02 03 04 01 02 03 04 01 02 01 02 03 04 01 02 03 04 01 02 01 02 03 04 01 02 03 04 01 02 01 02 03 04 01 02 03 04 01 02 00 02 03 04 01 02 03 04 01 02 01 02 03 04 01 02 03 04 01 02 03 04 01 02 03 04 01
01 02 03 04 01 02 03 04 01 02 01 02 03 04 01 02 03 04 01 02 01 02 03 04 01 02 03 04 01 02 01 02 03 04 01 02 03 04 01 02 01 00 03 04 01 02 03 04 01 02 01 02 03 04 01 02 03 04 01 02 03 04 01 02 03 04 01
01 02 03 04 01 02 03 04 01 02 01 02 03 04 01 02 03 04 01 02 01 02 03 04 01 02 03 04 01 02 01 02 03 04 01 02 03 04 01 02 01 02 00 04 01 02 03 04 01 02 01 02 03 04 01 02 03 04 01 02 03 04 01 02 03 04 01
01 02 03 04 01 02 03 04 01 02 01 02 03 04 01 02 03 04 01 02 01 02 03 04 01 02 03 04 01 02 01 02 03 04 01 02 03 04 01 02 01 02 03 00 01 02 03 04 01 02 01 02 03 04 01 02 03 04 01 02 03 04 01 02 03 04 01
01 02 03 04 01 02 03 04 01 02 01 02 03 04 01 02 03 04 01 02 01 02 03 04 01 02 03 04 01 02 01 02 03 04 01 02 03 04 01 02 01 02 03 04 00 02 03 04 01 02 01 02 03 04 01 02 03 04 01 02 03 04 01 02 03 04 01
01 02 03 04 01 02 03 04 01 02 01 02 03 04 01 02 03 04 01 02 01 02 03 04 01 02 03 04 01 00 00 02 03 04 01 02 03 04 01 02 01 02 03 04 01 01 03 04 01 02 01 02 03 04 01 02 03 04 01 02 03 04 01 02 03 04 01
01 02 03 04 01 02 03 04 01 02 01 02 03 04 01 02 03 04 01 02 01 02 03 04 01 02 00 00 01 02 01 02 03 04 01 02 03 04 01 02 01 02 03 04 01 02 01 04 01 02 01 02 03 04 01 02 03 04 01 02 03 04 01 02 03 04 01
01 02 03 04 01 02 03 04 01 02 01 02 03 04 01 02 03 04 01 02 01 02 00 00 00 02 03 04 01 02 01 02 03 04 01 02 03 04 01 02 01 02 03 04 01 02 03 01 01 02 01 02 03 04 01 02 03 04 01 02 03 04 01 02 03 04 01
01 02 03 04 01 02 03 04 01 02 01 02 03 04 01 02 03 04 01 02 01 02 03 04 01 02 03 04 01 02 01 02 03 04 01 02 03 04 01 02 01 02 03 04 01 02 03 01 01 02 01 02 03 04 01 02 03 04 01 02 03 04 01 02 03 04 01
00 00 00 00 00 00 00 00 00 00 00 00 00 00 00 00 00 00 00 00 00 00 00 00 00 00 00 00 00 00 00 00 00 00 00 00 00 00 00 00 00 00 00 00 00 00 00 00 00 00 00 00 00 00 00 00 00 00 00 00 00 00 00 00 00 00 00
